###############################
#p     ** *  1 * 2 *  * * *   #
# # # #*# # #*#*# # # #*#*#*# #
#  x*     ***  *  1   * 2 * * #
# # # # # #*# # #*#*# # # # #*#
#f         3 **  *  *   1     #
# # # # # # # # # #*# #*# # # #
#*  *      *  *      6        #
# # # # #*# # # #4#*# # # # # #
#*    **  *       *           #
# #*# # # # # # #*# # # # # # #
#        5   *  *  *          #
###############################